Humans: 10
RRRRRRRRRRRRRRRRRRRRRRRRRRRRR
R...........................R
R...........................R
R.@.........................R
R...........................R
R...........................R
R...........................R
R...........................R
R...........................R
R...........................R
R...........................R
R...........................R
R...........................R
R...........................R
R...........................R
R...........................R
R...........................R
R...........................R
R...........................R
R...........................R
R...........................R
R...........................R
RRRRRRRRRRRRRRRRRRRRRRRRRRRRR